R 1920 1080
NO ./wall_0.xpm
SO ./wall_1.xpm
WE ./wall_2.xpm
EA ./wall_3.xpm
S ./sp.xpm
F 169,169,169
C 119,136,153

11111111111
10000S00001
10000000001
10000220001
10000200001
10000000001
10000000001
10000000001
11111111111
